a-a-boterzuur	Butyrate
Alanine	Alanine
Arginine	Arginine
Asparagine	Asparagine
Asparaginezuur	Aspartic acid
Citrulline	Citrulline
Cystine	Cystine
Glutamine	Glutamine
Glutaminezuur	Glutamic acid
Glycine	Glycine
Histidine	Histidine
iso-leucine	Iso-leucine
leucine	Leucine
Lysine	Lysine
Methionine	Methionine
Ornithine	Ornithine
Phenylalanine	Phenylalanine
Proline	Proline
Serine	Serine
Taurine	Taurine
Threonine	Threonine
Tryptofaan	Tryptophan
Tyrosine	Tyrosine
Valine	Valine